1233212122
1        3
3        2
3        1
3       33
21232    3
1       11
3  2   311
3  2     1
3212312311